ROUND AND ROUND
      .      .      .      .      .      .      .      .      .      .      .      .      .      .      .      .      .      .      .      .      .      .      
      .      .      .      .      .      .      .      .      .      .      .      .      .      .      .      .      .      .      .      .      .      .      
      .      .      .      .      .      .      .      .      .      .      .      .      .      .      .      .      .      .      .      .      .      .      
      .      .      .      .WL_1  .WL_1  .      .WL_1  .WL_1  .WL_1  .WL_1  .      .      .      .      .      .      .      .      .      .      .      .      
      .      .      .      .WL_1  .CO_7  .WL_1  .CO_7  .WL_2  .WL_2  .WL_1  .      .      .      .      .      .      .      .      .      .      .      .      
      .      .      .      .      .WL_1  .      .CO_7  .      .      .      .      .      .      .      .      .      .      .      .      .      .      .      
      .      .      .      .WL_1  .CO_7  .CO_7  .      .WL_1  .      .WL_1  .      .      .      .      .      .      .      .      .      .      .      .      
      .      .      .      .WL_1  .WL_2  .      .WL_1  .CO_7  .WL_1  .CO_5  .      .      .      .      .      .      .      .      .      .      .      .      
      .      .      .      .WL_1  .WL_2  .      .      .      .WL_2  .WL_1  .      .      .      .      .      .      .      .      .      .      .      .      
      .      .      .      .WL_1  .WL_2  .      .WL_2  .WL_2  .WL_2  .WL_1  .      .      .      .      .      .      .      .      .      .      .      .      
      .      .      .      .WL_1  .WL_2  .      .WL_2  .WL_2  .WL_2  .WL_1  .      .      .      .      .      .      .      .      .      .      .      .      
      .      .      .      .WL_1  .WL_1  .      .WL_1  .WL_1  .WL_1  .WL_1  .      .      .      .      .      .      .      .      .      .      .      .      
      .      .      .      .      .      .      .      .      .      .      .      .      .      .      .      .      .LS_7:5.      .      .      .      .      
      .      .      .      .      .      .LS_1:7.      .      .      .      .      .      .      .      .      .      .      .      .      .      .      .      
      .      .      .      .      .      .      .      .      .      .      .      .      .      .      .      .      .      .      .      .      .      .      
      .      .      .      .      .      .      .      .      .      .      .      .      .      .      .      .      .      .      .      .      .      .      
9
MR_8=r
MR_8=r
MR_8=r
MR_8=r
MR_8=r
MR_8=r
RF_4=r
PR_8=r
PR_8=r
