IN THE MIX ...                                                                                                                  
      .      .      .      .      .      .      .      .      .      .      .      .      .      .      .      .      .      .      .      .      .      .      
      .      .      .      .WL_1  .WL_1  .WL_1  .WL_1  .WL_1  .WL_1  .WL_1  .WL_1  .WL_1  .WL_1  .WL_1  .WL_1  .WL_1  .      .      .      .      .      .      
      .      .      .      .WL_1  .      .      .CO_7  .      .      .      .      .      .      .WL_1  .WL_1  .WL_1  .      .      .      .      .      .      
      .      .      .      .WL_1  .      .      .      .      .      .      .CO_2  .      .CB_*  .WL_1  .WL_1  .WL_1  .      .      .      .      .      .      
      .      .      .      .WL_1  .CO_7  .      .WL_1  .WL_1  .WL_1  .      .      .      .      .WL_1  .WL_1  .WL_1  .      .      .      .      .      .      
      .      .      .      .WL_1  .      .      .WL_1  .WL_1  .WL_1  .      .      .      .CO_4  .      .      .WL_1  .      .      .      .      .      .      
      .      .WL_1  .WL_1  .WL_1  .      .      .      .      .      .      .      .      .      .      .      .WL_1  .      .      .      .      .      .      
      .      .WL_1  .LS_3:1.      .      .      .      .      .      .      .      .      .WL_1  .      .      .WL_1  .      .      .      .      .      .      
      .      .WL_1  .WL_1  .WL_1  .      .      .      .      .      .      .      .      .WL_1  .      .      .WL_1  .      .      .      .      .      .      
      .      .      .      .WL_1  .      .      .      .      .CO_4  .      .      .      .WL_1  .      .CO_6  .WL_1  .      .      .      .      .      .      
      .      .      .      .WL_1  .      .      .      .      .      .      .      .      .WL_1  .      .      .WL_1  .      .      .      .      .      .      
      .      .      .      .WL_1  .WL_1  .WL_1  .WL_1  .      .CO_3  .      .CB_*  .      .WL_1  .      .      .WL_1  .      .      .      .      .      .      
      .      .      .      .WL_1  .WL_1  .WL_1  .WL_1  .      .      .      .      .      .      .      .      .WL_1  .      .      .      .      .      .      
      .      .      .      .WL_1  .WL_1  .WL_1  .WL_1  .      .      .      .      .CO_6  .      .      .      .WL_1  .      .      .      .      .      .      
      .      .      .      .WL_1  .WL_1  .WL_1  .WL_1  .WL_1  .WL_1  .WL_1  .WL_1  .WL_1  .WL_1  .WL_1  .WL_1  .WL_1  .      .      .      .      .      .      
      .      .      .      .      .      .      .      .      .      .      .      .      .      .      .      .      .      .      .      .      .      .      
16
FT_6
FT_7
MR_8=r
MR_8=r
MR_8=r
MR_8=r
MR_8=r
MR_8=r
OW_8=r
OW_8=r
OW_8=r
OW_8=r
PR_8=r
PR_8=r
RF_4=r
SP_8=r
