EEEEUHM ...                                                                                                                     
      .      .      .      .      .      .      .      .      .      .      .      .      .      .      .      .      .      .      .      .      .      .      
      .      .WL_19 .WL_19 .WL_19 .WL_19 .WL_19 .WL_19 .WL_19 .WL_19 .WL_19 .WL_19 .WL_19 .WL_19 .WL_19 .      .      .      .      .      .      .      .      
      .      .WL_19 .WL_14 .WL_14 .WL_14 .WL_14 .WL_14 .WL_14 .WL_14 .WL_14 .WL_14 .WL_14 .WL_14 .WL_19 .      .      .      .      .      .      .      .      
      .WL_19 .WL_19 .WL_14 .      .      .      .      .      .      .      .      .      .WL_14 .WL_19 .WL_19 .WL_19 .WL_19 .      .      .      .      .      
      .WL_19 .WL_14 .WL_14 .      .WL_16 .WL_16 .WL_16 .WL_16 .CO_2  .WL_16 .WL_16 .      .WL_14 .WL_14 .WL_14 .WL_14 .WL_19 .      .      .      .      .      
      .WL_19 .WL_14 .CO_2  .      .      .      .      .      .      .      .CO_6  .      .      .      .      .WL_14 .WL_19 .      .      .      .      .      
      .WL_19 .WL_14 .WL_14 .CO_7  .WL_14 .      .WL_16 .WL_16 .      .WL_16 .WL_16 .      .WL_16 .WL_16 .      .WL_14 .WL_19 .      .      .      .      .      
      .WL_19 .WL_19 .WL_14 .WL_14 .WL_14 .      .WL_16 .WL_16 .      .WL_16 .WL_16 .      .WL_16 .WL_16 .      .WL_14 .WL_19 .      .      .      .      .      
      .      .WL_19 .WL_19 .WL_19 .WL_14 .      .WL_16 .WL_16 .      .WL_16 .WL_16 .      .WL_16 .WL_16 .      .WL_14 .WL_19 .      .      .      .      .      
      .      .      .WL_19 .WL_14 .WL_14 .OW_1  .WL_16 .WL_16 .OW_5  .WL_16 .WL_16 .OW_5  .WL_16 .WL_16 .OW_1  .WL_14 .WL_19 .      .      .      .      .      
      .      .      .WL_19 .WL_14 .LS_3:1.      .      .      .      .      .      .      .      .      .      .WL_14 .WL_19 .      .      .      .      .      
      .      .      .WL_19 .WL_14 .WL_14 .OW_1  .WL_16 .WL_16 .OW_5  .WL_16 .WL_16 .OW_5  .WL_16 .WL_16 .OW_5  .WL_14 .WL_19 .      .      .      .      .      
      .      .      .WL_19 .WL_19 .WL_14 .      .CO_7  .      .      .      .      .      .      .      .      .WL_14 .WL_19 .      .      .      .      .      
      .      .      .      .WL_19 .WL_14 .WL_14 .WL_14 .WL_14 .CO_4  .WL_14 .WL_14 .CO_2  .WL_14 .WL_14 .WL_14 .WL_14 .WL_19 .      .      .      .      .      
      .      .      .      .WL_19 .WL_19 .WL_19 .WL_19 .WL_14 .WL_14 .WL_14 .WL_14 .WL_14 .WL_14 .WL_19 .WL_19 .WL_19 .WL_19 .      .      .      .      .      
      .      .      .      .      .      .      .WL_19 .WL_19 .WL_19 .WL_19 .WL_19 .WL_19 .WL_19 .WL_19 .      .      .      .      .      .      .      .      
14
FT_2
FT_4
FT_6
FT_7
MD_4=r
MD_4=r
MR_8=r
MR_8=r
MR_8=r
MR_8=r
MR_8=r
SP_8=r
SP_8=r
SP_8=r
